NO wool/black_wool.xpm
SO      wool/yellow_wool.xpm
WE                   wool/cyan_wool.xpm                         
EA wool/red_wool.xpm
F 42,98,61
C 171,191,210

111111111111111
1111111111111111111111111111111
1000000000000000000000000000001
1001111111111111011001001001111
10000000000001 1001001000000001
1111111111001111111001111001101        
1000000000001      11    11  1
111111111111          11    11
1111001001111111111111001111001
1001001000001000000001001000W01
1001001111111111001111111001101
111111111111111111111111111  1
